NO ./images/wall_low_poly_256x256_1.png
SO ./images/wall_low_poly_256x256_2.png
WE  ./images/wall_low_poly_256x256_3.png
EA ./images/wall_low_poly_256x256_4.png

F   245,222,179
C 135,206,250



        1111111111111111111111111
        1000000000110010000100001
        101100000111001000W100001
        1001000000010010100000011
11111111101100000111000000010001
10000000001100000111011000011111
11110111111111011100000010001
11110111111111011101010010001
11000000110101011100000010001
10000000000000001100000010001
10000000000000001101010010001
110000011101010111110111100111
11110111 1110101 101111011111
11111111 1111111 111111111111
                  111111111

